111111111111111111111
1C00000000C00000C0001
1111111P0000000000011
111110000011111111111
1C0000C00000C00000001
111111100001111111111
1111E0000000000000001
111111111111111111111